11100000000000000000000020000000000000000000000000
00100000000000000000000020000000000000000000000000
00111111111111111111110022222222222222222222220000
00000010000000000000010020000000000000000000020000
00000010000222222222212220000001111111111000020000
00000010000200000000010000000001000000001000020000
00000010000200000000010000000001111110001000020000
00000010000200000000010000000000100000001000020000
00000010000200000000010000000000100000001000020000
00000010000200000000010000000000100000001000020000
00000010000220000000111111111111111111111000020000
00000010000020000000000000000000100000000000020000
00000010000020000111111111111111100000000000020000
00000010000020000111111000000000000000000000020000
00000010000020000111111000000000000000000000020000
00000010000020000000001000000000000000000000020000
00000010002220000000001000000000000000000000020000
00000010022020000000001000000000111111111100022222
00000010220022000000001111111113111111111100000200
00000012200002000000000000000000111111111100000200
02222212000022200000000000000000111111111100000200
22000010000022200000000000000000000000100000000200
00000010000022222222222222200000000000100000000200
00000010000000000000000000200000000000400000000200
00000010000000111111100000200000000000100000000200
00000011111111100000400000200000000000100000000200
00000000000000000001110000200000111111100000000200
00000000000000000001111111111111111110000000000200
00000000000000000001110000200000111110000022222200
00000000000000000000000000222222222222222220000000

