1110000000000000000000002000000000000000000000000000000000000000000000
0010000000000000000000002000000000000000000000000000000000000000000000
0011111111111111111111002222222222222222222222000000000000000000000000
0000001000000000000001002000000000000000000002000000000000000000000000
0000001000022222222221222000000111111111100002000000000000000000000000
0000001000020000000001000000000100000000100002000000000000000000000000
0000001000020000000001000000000111111000100002000000000000000000000000
0000001000020000000001000000000010000000100002000000000000000000000000
0000001000020000000001000000000010000000100002000000000000000000000000
0000001000020000000001000000000010000000100002000000000000000000000000
0000001000022000000011111111111111111111100002000000000000000000000000
0000001000002000000000000000000010000000000002000000000000000000000000
0000001000002000011111111111111110000000000002000000000000000000000000
0000001000002000011111100000000000000000000002000000000000000000000000
0000001000002000011111100000000000000000000002000000000000000000000000
0000001000002000000000100000000000000000000002000000000000000000000000
0000001000222000000000100000000000000000000002000000000000000000000000
0000001002202000000000100000000011111112222222222200000000000000000000
0000001022002200000000111111111311111112220000020000000000000000000000
0000001220000200000000000000000011111111110000020000000000000000000000
0222221200002220000000000000000000000010000000020000000000000000000000
2200001000002220000000000000000000000010000000020000000000000000000000
0000001000002222222222222220000000000010000000020000000000000000000000
0000001000000000000000000020000000000030000000020000000000000000000000
0000001000000011111110000020000000000010000000020000000000000000000000
0000001111111110000030000020000000000010000000020000000000000000000000
0000000000000000000111000020000011111110000000020000000000000000000000
0000000000000000000111111111111111111000000000020000000000000000000000
0000000000000000000111000020000011111000002222220000000000000000000000
0000000000000000000000000022222222222222222000000000000000000000000000
0000000001000000000000000022222222222222222000000000000000000000000000
0000000001000000000000000022222222222222222000000000000000000000000000
0000000001000000000000000022222222222222222000000000000000000000000000
0000000001000000000000000022222222222222222000000000000000000000000000
0000000001000000000000000022222222222222222000000000000000000000000000
0000000001000000000000000022222222222222222000000000000000000000000000
0000000001000000000000000022222222222222222000000000000000000000000000
0000000001000000000000000022222222222222222000000000000000000000000000
0000000001000000000000000022222222222222222000000000000000000000000000
0000000001000000000000000022222222222222222000000000000000000000000000