5555555555555555111111111115555555555
5110101001111100111111111111101111005
5111111100100110111111111111001011105
5000010111000100111111111111101001005
5101011011011101111111111111100110015
5111001100101000111111111110010110015
5111100011011000111111111111110011015
5111110001001111111111111110110011105
5110001001101111111111111111011000015
5110110110001111111111111110111101115
5100111111111111111111111111111110015
5111111111111111111111110111101001115
5101111111111111111111100011001000015
5010111111111111111111100011101100115
5110111111111111111111111000100000115
5011111111111111111111100011000011015
5110111111111111111111111110000111105
5000111111111111111111110011001111005
5100111111111111111111100101110111005
5111111111111111111111101000101100015
5110111111111111111111101110100011015
5001001010001111111111110100100010015
5010011100111111111111110111111010115
5010011101011111111111101001011110105
5555555555555555555555555555555555555