1110000000000000000000000000000000000000
1110000000011110000000000000001111100000
1111111111311110000000000000000000100000
0000000100011111111111111110000000100000
0000000100000000000000111111111111100000
0011111100000000001113111110000000100000
0000100000000000001000000000000001100000
0000100000011111111000000000000001000000
0111111111110000000000000000000001000000
0100100000010000000000000000000001000000
0111100000011111111111111111111111000000
0000000000010000000000000000000000000000
0000000111111111000000000000000000000000
0000000111111111000000000000000000000000
0000000111111111111111111110000000000000
0000000000000000000000040000000000000000
0000111111111111111111111111111111110000
0000100000000000000000010000000000010000
0000100000000000000111111111000000010000
0000100000000000000100000001000000040000
0000100000011111111100000001111111311100
0000100000010000000100000001000000011100
0000111111310000000111111111000000011100
0000000000011111100100000000000000000000
0000000000000000111100000000000000000000
